Player,Pos,Age,Tm,G,GS,MP,FG,FGA,FG%,3P,3PA,3P%,2P,2PA,2P%,eFG%,FT,FTA,FT%,ORB,DRB,TRB,AST,STL,BLK,TOV,PF,PTS,Rk
Precious Achiuwa,C,24,TOR,14,0,254,41,95,0.432,6,23,0.261,35,72,0.486,0.463,14,25,0.56,32,54,86,28,8,6,18,25,102,1
Bam Adebayo,C,26,MIA,16,16,537,132,253,0.522,1,3,0.333,131,250,0.524,0.524,91,112,0.813,33,126,159,62,19,16,39,39,356,2
Ochai Agbaji,SG,23,UTA,19,7,376,41,92,0.446,23,59,0.39,18,33,0.545,0.571,4,6,0.667,18,34,52,22,12,12,13,27,109,3
Santi Aldama,PF,23,MEM,12,4,323,69,149,0.463,22,68,0.324,47,81,0.58,0.537,14,23,0.609,19,56,75,24,7,8,15,19,174,4
Nickeil Alexander-Walker,SG,25,MIN,18,7,417,46,112,0.411,26,73,0.356,20,39,0.513,0.527,3,9,0.333,8,31,39,49,18,14,19,36,121,5
Grayson Allen,SG,28,PHO,17,17,557,71,144,0.493,39,84,0.464,32,60,0.533,0.628,23,27,0.852,13,68,81,49,10,7,26,41,204,6
Jarrett Allen,C,25,CLE,14,14,406,75,111,0.676,0,0,,75,111,0.676,0.676,38,50,0.76,43,67,110,32,7,17,24,38,188,7
Jose Alvarado,PG,25,NOP,6,0,96,16,39,0.41,7,19,0.368,9,20,0.45,0.5,2,6,0.333,4,9,13,12,7,1,6,9,41,8
Kyle Anderson,PF,30,MIN,18,0,433,51,100,0.51,2,12,0.167,49,88,0.557,0.52,23,37,0.622,13,53,66,72,14,15,29,25,127,9
Giannis Antetokounmpo,PF,29,MIL,18,18,616,205,341,0.601,8,34,0.235,197,307,0.642,0.613,119,183,0.65,51,143,194,84,24,25,74,58,537,10
Thanasis Antetokounmpo,PF,31,MIL,7,0,44,3,8,0.375,0,0,,3,8,0.375,0.375,0,0,,2,2,4,4,1,1,4,7,6,11
Cole Anthony,PG,23,ORL,19,0,484,90,205,0.439,27,72,0.375,63,133,0.474,0.505,77,91,0.846,22,64,86,70,15,9,40,57,284,12
Ryan Arcidiacono,PG,29,NYK,5,0,11,0,1,0.0,0,1,0.0,0,0,,0.0,0,0,,0,2,2,0,0,0,0,0,0,14
Deni Avdija,SF,23,WAS,19,19,506,92,175,0.526,20,52,0.385,72,123,0.585,0.583,29,35,0.829,25,75,100,70,17,5,27,44,233,15
Deandre Ayton,C,25,POR,17,17,539,104,176,0.591,0,0,,104,176,0.591,0.591,15,19,0.789,55,128,183,28,22,13,35,43,223,16
Marvin Bagley III,C,24,DET,18,6,336,73,126,0.579,1,5,0.2,72,121,0.595,0.583,40,46,0.87,34,54,88,23,1,12,22,28,187,18
Patrick Baldwin Jr.,SF,21,WAS,3,0,11,0,2,0.0,0,1,0.0,0,1,0.0,0.0,0,0,,0,1,1,1,0,0,0,1,0,20
LaMelo Ball,PG,22,CHO,15,15,501,132,298,0.443,52,134,0.388,80,164,0.488,0.53,54,63,0.857,23,59,82,123,21,4,59,52,370,21
Mo Bamba,C,25,PHI,9,0,57,13,24,0.542,3,7,0.429,10,17,0.588,0.604,6,8,0.75,12,9,21,1,1,7,6,7,35,22
Paolo Banchero,PF,21,ORL,19,19,634,135,278,0.486,27,59,0.458,108,219,0.493,0.534,74,112,0.661,26,101,127,89,20,11,61,43,371,23
Desmond Bane,SG,25,MEM,18,18,616,154,345,0.446,59,162,0.364,95,183,0.519,0.532,58,68,0.853,17,64,81,94,24,12,50,54,425,24
Dalano Banton,PG,24,BOS,9,1,80,13,26,0.5,1,7,0.143,12,19,0.632,0.519,5,6,0.833,9,12,21,4,2,2,2,11,32,25
Harrison Barnes,PF,31,SAC,17,17,533,70,147,0.476,32,85,0.376,38,62,0.613,0.585,38,45,0.844,12,43,55,27,14,2,14,20,210,27
Scottie Barnes,SG,22,TOR,20,20,696,146,313,0.466,39,102,0.382,107,211,0.507,0.529,61,79,0.772,53,128,181,109,36,26,46,42,392,28
RJ Barrett,SG,23,NYK,14,14,410,88,209,0.421,28,72,0.389,60,137,0.438,0.488,56,67,0.836,7,44,51,38,7,3,28,22,260,29
Charles Bassey,C,23,SAS,19,0,205,29,40,0.725,0,1,0.0,29,39,0.744,0.725,5,6,0.833,23,53,76,21,8,17,15,31,63,30
Keita Bates-Diop,SF,28,PHO,16,7,314,32,78,0.41,8,30,0.267,24,48,0.5,0.462,22,29,0.759,18,37,55,15,11,14,3,19,94,32
Nicolas Batum,PF,35,TOT,13,7,308,27,48,0.563,20,39,0.513,7,9,0.778,0.771,3,4,0.75,12,36,48,21,9,11,7,27,77,33
Bradley Beal,SG,30,PHO,3,3,86,18,46,0.391,5,15,0.333,13,31,0.419,0.446,11,16,0.688,3,13,16,11,2,1,9,9,52,34
Malik Beasley,SG,27,MIL,19,19,544,79,166,0.476,54,122,0.443,25,44,0.568,0.639,8,12,0.667,11,75,86,27,19,3,14,38,220,35
MarJon Beauchamp,SF,23,MIL,15,0,242,31,69,0.449,13,33,0.394,18,36,0.5,0.543,8,12,0.667,10,27,37,14,4,2,11,27,83,36
Davis Bertans,PF,31,OKC,5,0,46,3,13,0.231,3,12,0.25,0,1,0.0,0.346,8,9,0.889,0,4,4,4,1,1,0,5,17,37
Patrick Beverley,PG,35,PHI,19,1,345,32,72,0.444,11,36,0.306,21,36,0.583,0.521,11,16,0.688,18,43,61,48,10,6,13,39,86,38
Saddiq Bey,SF,24,ATL,18,6,518,81,161,0.503,30,79,0.38,51,82,0.622,0.596,26,33,0.788,34,68,102,22,21,3,22,29,218,39
Goga Bitadze,C,24,ORL,17,14,344,44,77,0.571,1,4,0.25,43,73,0.589,0.578,28,38,0.737,35,68,103,32,14,25,13,42,117,40
Anthony Black,PG,20,ORL,17,13,325,31,67,0.463,7,24,0.292,24,43,0.558,0.515,13,20,0.65,10,28,38,26,5,7,19,35,82,43
Bogdan Bogdanovic,SG,31,ATL,18,1,479,103,223,0.462,56,142,0.394,47,81,0.58,0.587,23,25,0.92,7,49,56,44,26,6,25,44,285,45
Bol Bol,PF,24,PHO,3,0,7,1,1,1.0,0,0,,1,1,1.0,1.0,0,0,,0,1,1,0,0,1,2,0,2,46
Devin Booker,SG,27,PHO,10,10,339,91,191,0.476,20,50,0.4,71,141,0.504,0.529,71,77,0.922,10,44,54,85,7,5,30,30,273,48
Chris Boucher,PF,31,TOR,18,0,268,40,86,0.465,14,33,0.424,26,53,0.491,0.547,31,38,0.816,24,47,71,8,7,9,7,32,125,49
James Bouknight,SG,23,CHO,1,0,5,2,3,0.667,1,2,0.5,1,1,1.0,0.833,0,0,,1,0,1,0,0,0,0,0,5,50
Malaki Branham,SG,20,SAS,19,8,392,65,155,0.419,18,62,0.29,47,93,0.505,0.477,8,9,0.889,4,22,26,41,8,2,22,25,156,52
Christian Braun,SG,22,DEN,20,0,420,68,144,0.472,13,32,0.406,55,112,0.491,0.517,27,37,0.73,19,66,85,40,7,4,14,33,176,53
Mikal Bridges,SF,27,BRK,18,18,630,145,307,0.472,37,106,0.349,108,201,0.537,0.533,65,76,0.855,21,92,113,71,20,6,45,31,392,54
Miles Bridges,SF,25,CHO,7,5,255,51,100,0.51,14,31,0.452,37,69,0.536,0.58,26,32,0.813,6,47,53,18,9,3,12,12,142,55
Oshae Brissett,SF,25,BOS,8,0,90,3,17,0.176,1,9,0.111,2,8,0.25,0.206,7,12,0.583,8,13,21,3,4,0,2,9,14,56
Malcolm Brogdon,PG,31,POR,13,8,372,83,201,0.413,25,69,0.362,58,132,0.439,0.475,39,48,0.813,14,42,56,83,11,2,23,18,230,57
Dillon Brooks,SF,28,HOU,16,16,488,77,160,0.481,28,64,0.438,49,96,0.51,0.569,33,40,0.825,11,44,55,29,16,1,29,65,215,59
Bruce Brown,SG,27,IND,17,17,536,74,158,0.468,21,63,0.333,53,95,0.558,0.535,29,35,0.829,9,63,72,48,20,5,18,41,198,60
Jaylen Brown,SF,27,BOS,18,18,621,149,332,0.449,43,126,0.341,106,206,0.515,0.514,51,72,0.708,10,79,89,61,22,11,44,50,392,61
Kobe Brown,PF,24,LAC,9,0,74,8,19,0.421,4,12,0.333,4,7,0.571,0.526,0,0,,3,11,14,2,1,1,1,13,20,62
Moses Brown,C,24,POR,3,0,14,3,5,0.6,0,0,,3,5,0.6,0.6,0,2,0.0,4,1,5,1,1,1,0,1,6,63
Troy Brown Jr.,SF,24,MIN,14,1,175,18,43,0.419,9,26,0.346,9,17,0.529,0.523,17,20,0.85,10,29,39,9,4,1,6,8,62,64
Jalen Brunson,PG,27,NYK,19,19,675,169,362,0.467,63,133,0.474,106,229,0.463,0.554,73,88,0.83,13,58,71,105,19,1,37,41,474,65
Thomas Bryant,C,26,MIA,13,3,168,27,54,0.5,0,3,0.0,27,51,0.529,0.5,12,15,0.8,13,36,49,8,6,4,12,17,66,66
Kobe Bufkin,SG,20,ATL,2,0,4,0,3,0.0,0,1,0.0,0,2,0.0,0.0,1,2,0.5,1,1,2,0,0,0,0,0,1,67
Reggie Bullock Jr.,SF,32,HOU,8,0,76,4,13,0.308,4,12,0.333,0,1,0.0,0.462,0,0,,2,11,13,3,1,1,2,7,12,68
Alec Burks,SG,32,DET,13,0,258,38,110,0.345,26,71,0.366,12,39,0.308,0.464,38,44,0.864,7,24,31,25,5,4,5,21,140,69
Jimmy Butler,PF,34,MIA,15,15,504,99,214,0.463,17,42,0.405,82,172,0.477,0.502,111,126,0.881,31,50,81,59,19,8,27,12,326,71
Kentavious Caldwell-Pope,SG,30,DEN,20,20,682,78,170,0.459,33,78,0.423,45,92,0.489,0.556,37,39,0.949,10,28,38,54,31,9,24,44,226,73
Toumani Camara,PF,23,POR,18,9,443,39,97,0.402,14,47,0.298,25,50,0.5,0.474,20,27,0.741,31,43,74,20,14,11,20,44,112,74
Clint Capela,C,29,ATL,18,18,435,83,140,0.593,0,0,,83,140,0.593,0.593,26,44,0.591,79,96,175,16,13,29,14,39,192,75
Jevon Carter,PG,28,CHI,20,0,289,44,112,0.393,25,68,0.368,19,44,0.432,0.504,0,1,0.0,2,10,12,23,11,6,13,22,113,76
Wendell Carter Jr.,C,24,ORL,5,5,147,17,45,0.378,5,16,0.313,12,29,0.414,0.433,8,14,0.571,11,32,43,8,3,2,8,14,47,77
Alex Caruso,SG,29,CHI,17,6,409,58,108,0.537,29,61,0.475,29,47,0.617,0.671,21,27,0.778,20,37,57,40,25,13,23,39,166,78
Julian Champagnie,SF,22,SAS,12,5,194,27,73,0.37,20,52,0.385,7,21,0.333,0.507,8,11,0.727,5,19,24,13,6,9,13,11,82,81
Max Christie,SG,20,LAL,15,5,264,26,68,0.382,8,32,0.25,18,36,0.5,0.441,9,10,0.9,3,37,40,15,7,4,12,22,69,82
Sidy Cissoko,SF,19,SAS,1,0,4,0,0,,0,0,,0,0,,,0,0,,0,0,0,0,0,0,1,0,0,83
Jordan Clarkson,SG,31,UTA,17,17,536,110,266,0.414,31,98,0.316,79,168,0.47,0.472,51,61,0.836,21,35,56,84,14,2,54,24,302,84
Nic Claxton,C,24,BRK,9,9,247,54,80,0.675,0,0,,54,80,0.675,0.675,13,22,0.591,31,49,80,14,6,25,7,21,121,85
Noah Clowney,PF,19,BRK,1,0,3,0,0,,0,0,,0,0,,,0,0,,0,1,1,0,0,0,0,0,0,86
Amir Coffey,SF,26,LAC,10,0,58,4,12,0.333,0,3,0.0,4,9,0.444,0.333,4,4,1.0,2,5,7,3,1,0,2,5,12,87
John Collins,PF,26,UTA,19,19,589,103,214,0.481,29,70,0.414,74,144,0.514,0.549,36,51,0.706,52,107,159,15,11,14,25,57,271,88
Zach Collins,C,26,SAS,19,19,554,98,199,0.492,21,77,0.273,77,122,0.631,0.545,46,57,0.807,37,77,114,74,14,14,53,67,263,89
Mike Conley,PG,36,MIN,18,18,526,64,144,0.444,39,90,0.433,25,54,0.463,0.58,16,16,1.0,9,41,50,108,18,2,16,33,183,90
Pat Connaughton,SF,31,MIL,18,0,416,38,90,0.422,20,59,0.339,18,31,0.581,0.533,8,12,0.667,12,51,63,36,9,3,14,19,104,91
Bilal Coulibaly,SF,19,WAS,18,1,474,56,108,0.519,20,46,0.435,36,62,0.581,0.611,16,24,0.667,8,60,68,29,19,13,26,33,148,92
Robert Covington,SF-PF,33,TOT,19,6,356,34,77,0.442,17,46,0.37,17,31,0.548,0.552,18,21,0.857,26,43,69,18,29,15,6,38,103,93
Torrey Craig,SF,33,CHI,20,7,430,37,94,0.394,14,48,0.292,23,46,0.5,0.468,10,11,0.909,34,63,97,22,12,8,13,47,98,94
Jae Crowder,PF,33,MIL,9,2,240,25,47,0.532,16,31,0.516,9,16,0.563,0.702,7,12,0.583,4,31,35,15,7,3,4,14,73,95
Cade Cunningham,PG,22,DET,19,19,664,157,377,0.416,39,114,0.342,118,263,0.449,0.468,71,80,0.888,10,59,69,134,16,4,86,53,424,96
Seth Curry,SG,33,DAL,13,0,125,18,43,0.419,7,23,0.304,11,20,0.55,0.5,6,7,0.857,3,12,15,10,7,1,4,10,49,97
Stephen Curry,PG,35,GSW,17,17,565,154,320,0.481,87,202,0.431,67,118,0.568,0.617,106,114,0.93,13,73,86,73,13,4,62,32,501,98
Dyson Daniels,PG,20,NOP,20,11,532,59,145,0.407,15,61,0.246,44,84,0.524,0.459,15,24,0.625,22,76,98,70,30,8,28,41,148,99
Anthony Davis,C,30,LAL,19,19,665,162,293,0.553,3,11,0.273,159,282,0.564,0.558,103,122,0.844,60,175,235,62,21,51,41,55,430,100
Johnny Davis,SG,21,WAS,14,0,128,19,40,0.475,1,3,0.333,18,37,0.486,0.488,4,5,0.8,8,11,19,5,7,1,5,10,43,101
DeMar DeRozan,SF,34,CHI,18,18,633,135,300,0.45,16,44,0.364,119,256,0.465,0.477,98,121,0.81,17,41,58,83,18,15,21,37,384,103
Gradey Dick,SG,20,TOR,15,1,220,17,63,0.27,10,41,0.244,7,22,0.318,0.349,14,14,1.0,7,15,22,15,4,0,12,23,58,105
Ousmane Dieng,PF,20,OKC,12,0,122,13,37,0.351,7,26,0.269,6,11,0.545,0.446,3,4,0.75,6,16,22,11,1,0,4,7,36,106
Spencer Dinwiddie,PG,30,BRK,17,17,530,75,188,0.399,39,112,0.348,36,76,0.474,0.503,54,67,0.806,9,59,68,110,11,2,28,27,243,107
Donte DiVincenzo,SG,27,NYK,19,2,388,60,141,0.426,43,99,0.434,17,42,0.405,0.578,11,17,0.647,15,39,54,32,18,6,21,26,174,108
Luka Doncic,PG,24,DAL,17,17,599,183,374,0.489,64,165,0.388,119,209,0.569,0.575,99,128,0.773,10,126,136,134,22,7,62,31,529,109
Luguentz Dort,SF,24,OKC,18,18,505,62,136,0.456,32,75,0.427,30,61,0.492,0.574,30,38,0.789,20,53,73,22,18,15,17,53,186,110
Ayo Dosunmu,SG,24,CHI,18,1,302,41,83,0.494,14,38,0.368,27,45,0.6,0.578,12,16,0.75,9,22,31,29,11,2,11,28,108,111
Andre Drummond,C,30,CHI,20,0,262,45,84,0.536,0,1,0.0,45,83,0.542,0.536,25,42,0.595,51,77,128,12,21,6,21,32,115,112
Chris Duarte,SF,26,SAC,17,5,257,28,71,0.394,14,42,0.333,14,29,0.483,0.493,10,14,0.714,4,30,34,16,12,1,11,47,80,113
Kris Dunn,PG,29,UTA,13,1,134,19,44,0.432,4,9,0.444,15,35,0.429,0.477,5,8,0.625,4,19,23,25,7,1,15,17,47,114
Kevin Durant,PF,35,PHO,17,17,626,180,357,0.504,38,78,0.487,142,279,0.509,0.557,133,147,0.905,5,109,114,99,13,21,62,31,531,115
Jalen Duren,C,20,DET,12,11,344,64,107,0.598,0,2,0.0,64,105,0.61,0.598,14,21,0.667,43,88,131,34,7,16,34,44,142,116
Tari Eason,PF,22,HOU,9,0,159,26,55,0.473,6,15,0.4,20,40,0.5,0.527,3,7,0.429,14,36,50,7,4,11,6,18,61,117
Anthony Edwards,SG,22,MIN,17,17,597,157,338,0.464,43,114,0.377,114,224,0.509,0.528,89,103,0.864,13,87,100,85,22,8,55,33,446,118
Kessler Edwards,SF,23,SAC,14,0,90,6,21,0.286,4,14,0.286,2,7,0.286,0.381,1,2,0.5,3,12,15,5,2,2,1,8,17,119
Joel Embiid,C,29,PHI,16,16,552,165,331,0.498,17,54,0.315,148,277,0.534,0.524,165,188,0.878,52,128,180,106,16,30,59,48,512,121
Drew Eubanks,C,26,PHO,18,0,322,48,81,0.593,2,2,1.0,46,79,0.582,0.605,23,28,0.821,26,57,83,27,3,19,19,37,121,122
Dante Exum,PG,28,DAL,16,0,170,32,63,0.508,4,17,0.235,28,46,0.609,0.54,9,15,0.6,8,28,36,24,5,2,5,16,77,123
Bruno Fernando,C,25,ATL,5,0,16,3,9,0.333,0,1,0.0,3,8,0.375,0.333,1,1,1.0,3,1,4,0,0,0,4,3,7,124
Dorian Finney-Smith,PF,30,BRK,18,17,566,74,159,0.465,49,108,0.454,25,51,0.49,0.619,1,3,0.333,37,62,99,26,9,12,17,42,198,125
Malachi Flynn,PG,25,TOR,20,0,331,38,92,0.413,18,53,0.34,20,39,0.513,0.511,12,16,0.75,9,32,41,43,13,4,19,27,106,126
Simone Fontecchio,SF,28,UTA,17,4,285,44,97,0.454,28,69,0.406,16,28,0.571,0.598,7,8,0.875,13,27,40,16,7,5,16,23,123,127
Evan Fournier,SG,31,NYK,1,0,16,1,6,0.167,0,4,0.0,1,2,0.5,0.167,0,0,,0,1,1,1,1,0,0,2,2,130
De'Aaron Fox,PG,26,SAC,12,12,435,130,266,0.489,37,102,0.363,93,164,0.567,0.558,71,97,0.732,12,45,57,70,18,4,25,36,368,131
Markelle Fultz,PG,25,ORL,5,5,143,27,56,0.482,0,3,0.0,27,53,0.509,0.482,3,4,0.75,8,9,17,20,6,2,6,6,57,133
Daniel Gafford,C,25,WAS,17,17,427,71,101,0.703,0,0,,71,101,0.703,0.703,25,39,0.641,45,84,129,27,11,35,20,58,167,134
Danilo Gallinari,PF,35,WAS,17,0,267,46,96,0.479,14,42,0.333,32,54,0.593,0.552,30,37,0.811,10,44,54,25,4,3,8,18,136,135
Darius Garland,PG,24,CLE,14,14,467,96,204,0.471,22,65,0.338,74,139,0.532,0.525,53,64,0.828,8,30,38,83,20,3,62,22,267,136
Keyonte George,PG,20,UTA,19,11,485,59,173,0.341,31,95,0.326,28,78,0.359,0.431,40,49,0.816,10,49,59,93,10,2,40,22,189,139
Paul George,PF,33,LAC,18,18,638,145,328,0.442,57,152,0.375,88,176,0.5,0.529,74,80,0.925,12,93,105,75,30,3,45,52,421,140
Josh Giddey,SG,21,OKC,18,18,483,93,214,0.435,11,36,0.306,82,178,0.461,0.46,21,27,0.778,27,79,106,78,14,9,49,23,218,141
Harry Giles III,C,25,BRK,2,0,12,5,6,0.833,1,2,0.5,4,4,1.0,0.917,1,1,1.0,0,2,2,0,0,0,1,2,12,142
Shai Gilgeous-Alexander,PG,25,OKC,17,17,583,190,351,0.541,21,60,0.35,169,291,0.581,0.571,120,127,0.945,14,86,100,104,39,15,37,40,521,143
Anthony Gill,PF,31,WAS,11,0,68,10,20,0.5,0,3,0.0,10,17,0.588,0.5,10,12,0.833,4,9,13,5,3,3,7,5,30,144
Rudy Gobert,C,31,MIN,18,18,583,84,144,0.583,0,0,,84,144,0.583,0.583,58,95,0.611,67,142,209,20,11,42,29,52,226,147
Jordan Goodwin,PG,25,PHO,19,0,322,44,112,0.393,19,54,0.352,25,58,0.431,0.478,11,14,0.786,21,50,71,40,15,6,14,21,118,148
Aaron Gordon,PF,28,DEN,16,16,542,88,181,0.486,8,36,0.222,80,145,0.552,0.508,26,50,0.52,42,73,115,61,18,14,29,31,210,149
Eric Gordon,SG,35,PHO,18,14,568,101,214,0.472,52,126,0.413,49,88,0.557,0.593,11,14,0.786,7,32,39,53,18,10,27,27,265,150
Devonte' Graham,PG,28,SAS,3,0,36,2,7,0.286,0,4,0.0,2,3,0.667,0.286,4,5,0.8,1,1,2,11,2,1,2,2,8,151
Jerami Grant,PF,29,POR,18,18,638,138,309,0.447,49,114,0.43,89,195,0.456,0.526,86,105,0.819,13,57,70,42,16,16,44,40,411,152
AJ Green,SG,24,MIL,11,0,81,11,30,0.367,8,26,0.308,3,4,0.75,0.5,1,1,1.0,1,7,8,8,0,0,0,8,31,153
Danny Green,SG,36,PHI,2,0,18,0,2,0.0,0,1,0.0,0,1,0.0,0.0,0,0,,0,2,2,1,1,0,0,1,0,154
Draymond Green,PF,33,GSW,11,11,262,34,72,0.472,13,28,0.464,21,44,0.477,0.563,19,22,0.864,14,43,57,59,6,7,22,31,100,155
Jalen Green,SG,21,HOU,16,16,510,104,242,0.43,36,100,0.36,68,142,0.479,0.504,69,87,0.793,6,65,71,54,10,7,36,25,313,156
Jeff Green,PF,37,HOU,16,0,236,34,61,0.557,7,21,0.333,27,40,0.675,0.615,26,34,0.765,13,24,37,10,3,7,8,15,101,157
Josh Green,SG,23,DAL,18,5,454,46,109,0.422,23,63,0.365,23,46,0.5,0.528,9,17,0.529,10,42,52,43,17,3,17,31,124,158
AJ Griffin,SF,20,ATL,11,0,101,10,33,0.303,8,24,0.333,2,9,0.222,0.424,2,2,1.0,2,8,10,3,1,0,4,5,30,159
Quentin Grimes,SG,23,NYK,17,17,393,37,102,0.363,29,83,0.349,8,19,0.421,0.505,2,3,0.667,4,18,22,21,13,0,9,29,105,160
Mouhamed Gueye,PF,21,ATL,2,0,4,0,1,0.0,0,1,0.0,0,0,,0.0,0,0,,0,0,0,0,1,0,0,1,0,161
Rui Hachimura,PF,25,LAL,12,1,279,52,103,0.505,15,35,0.429,37,68,0.544,0.578,22,28,0.786,12,34,46,12,11,3,12,18,141,162
Tyrese Haliburton,PG,23,IND,16,16,543,148,285,0.519,63,141,0.447,85,144,0.59,0.63,73,83,0.88,7,51,58,189,17,11,40,17,432,163
R.J. Hampton,PG,22,MIA,1,0,2,0,1,0.0,0,0,,0,1,0.0,0.0,0,0,,0,0,0,0,0,0,0,0,0,164
Tim Hardaway Jr.,SF,31,DAL,17,0,468,97,231,0.42,58,151,0.384,39,80,0.488,0.545,33,37,0.892,6,51,57,27,4,0,14,15,285,165
James Harden,SG,34,LAC,13,13,437,60,131,0.458,32,78,0.41,28,53,0.528,0.58,47,56,0.839,5,52,57,81,21,6,29,25,199,166
Jaden Hardy,SG,21,DAL,15,0,167,33,85,0.388,10,37,0.27,23,48,0.479,0.447,17,25,0.68,6,19,25,19,5,0,10,12,93,167
Gary Harris,SG,29,ORL,14,2,292,39,80,0.488,24,58,0.414,15,22,0.682,0.638,12,17,0.706,8,18,26,25,13,4,8,17,114,169
Joe Harris,SG,32,DET,7,0,98,9,25,0.36,6,19,0.316,3,6,0.5,0.48,0,0,,2,5,7,6,2,0,3,12,24,170
Tobias Harris,PF,31,PHI,19,19,669,130,252,0.516,20,62,0.323,110,190,0.579,0.556,62,70,0.886,17,98,115,51,18,6,37,31,342,171
Josh Hart,SF,28,NYK,19,5,545,62,133,0.466,20,58,0.345,42,75,0.56,0.541,11,15,0.733,20,98,118,49,18,6,19,33,155,173
Isaiah Hartenstein,C,25,NYK,19,0,322,41,73,0.562,1,3,0.333,40,70,0.571,0.568,20,30,0.667,46,48,94,17,18,9,15,51,103,174
Sam Hauser,SF,26,BOS,19,2,436,63,134,0.47,52,119,0.437,11,15,0.733,0.664,7,8,0.875,16,50,66,16,10,7,12,29,185,175
Jordan Hawkins,SG,21,NOP,20,9,559,85,215,0.395,54,145,0.372,31,70,0.443,0.521,36,42,0.857,16,62,78,38,10,0,22,40,260,176
Jaxson Hayes,C,23,LAL,17,0,190,22,31,0.71,0,2,0.0,22,29,0.759,0.71,12,21,0.571,7,21,28,7,4,9,13,30,56,177
Killian Hayes,PG,22,DET,18,14,477,66,157,0.42,16,52,0.308,50,105,0.476,0.471,20,29,0.69,5,43,48,79,21,12,13,37,168,178
Gordon Hayward,SF,33,CHO,16,16,517,84,199,0.422,14,41,0.341,70,158,0.443,0.457,39,53,0.736,18,67,85,75,18,8,29,30,221,179
Scoot Henderson,PG,19,POR,9,5,229,29,87,0.333,7,36,0.194,22,51,0.431,0.374,10,15,0.667,6,16,22,39,4,1,32,36,75,180
Taylor Hendricks,PF,20,UTA,1,0,2,0,0,,0,0,,0,0,,,1,2,0.5,0,1,1,0,0,0,0,0,1,181
Tyler Herro,SG,24,MIA,8,8,272,68,152,0.447,25,61,0.41,43,91,0.473,0.53,22,25,0.88,3,37,40,37,11,0,20,13,183,182
Buddy Hield,SF,31,IND,17,5,422,86,191,0.45,52,131,0.397,34,60,0.567,0.586,6,7,0.857,9,42,51,47,11,11,26,33,230,183
Haywood Highsmith,PF,27,MIA,14,13,331,35,81,0.432,16,48,0.333,19,33,0.576,0.531,11,13,0.846,9,32,41,23,17,11,14,31,97,184
Aaron Holiday,PG,27,HOU,14,1,258,33,73,0.452,13,37,0.351,20,36,0.556,0.541,6,7,0.857,2,24,26,28,8,1,6,26,85,187
Jrue Holiday,PG,33,BOS,17,17,587,80,188,0.426,30,78,0.385,50,110,0.455,0.505,21,26,0.808,31,92,123,88,11,15,38,29,211,188
Justin Holiday,SG,34,DEN,11,4,162,22,37,0.595,14,27,0.519,8,10,0.8,0.784,0,0,,3,15,18,15,6,0,3,13,58,189
Richaun Holmes,C,30,DAL,9,1,105,12,24,0.5,0,0,,12,24,0.5,0.5,4,10,0.4,15,23,38,5,1,5,6,17,28,190
Chet Holmgren,C,21,OKC,18,18,540,115,214,0.537,32,78,0.41,83,136,0.61,0.612,61,70,0.871,30,111,141,47,17,38,35,51,323,191
Jalen Hood-Schifino,SG,20,LAL,3,0,41,4,13,0.308,1,7,0.143,3,6,0.5,0.346,4,8,0.5,0,2,2,3,0,0,3,6,13,192
Al Horford,C,37,BOS,17,7,446,50,103,0.485,23,64,0.359,27,39,0.692,0.597,7,7,1.0,27,85,112,47,9,18,16,32,130,193
Talen Horton-Tucker,PG,23,UTA,19,8,425,64,175,0.366,21,73,0.288,43,102,0.422,0.426,22,25,0.88,10,46,56,85,16,9,37,43,171,194
Danuel House Jr.,SF,30,PHI,10,0,127,13,31,0.419,4,16,0.25,9,15,0.6,0.484,8,10,0.8,4,10,14,8,5,1,9,10,38,195
Caleb Houstan,SF,21,ORL,11,0,79,10,18,0.556,9,17,0.529,1,1,1.0,0.806,4,4,1.0,2,11,13,5,2,0,3,8,33,196
Jett Howard,SF,20,ORL,5,0,23,1,10,0.1,0,8,0.0,1,2,0.5,0.1,0,0,,1,1,2,2,0,0,2,0,2,197
Kevin Huerter,SG,25,SAC,16,16,441,76,172,0.442,40,108,0.37,36,64,0.563,0.558,13,16,0.813,12,62,74,50,13,5,14,39,205,198
De'Andre Hunter,SF,26,ATL,18,18,539,87,190,0.458,33,90,0.367,54,100,0.54,0.545,53,60,0.883,13,64,77,25,16,7,27,60,260,200
Bones Hyland,PG,23,LAC,12,2,201,37,88,0.42,17,48,0.354,20,40,0.5,0.517,9,10,0.9,2,12,14,24,7,0,19,22,100,201
Joe Ingles,SF,36,ORL,19,0,361,33,79,0.418,19,50,0.38,14,29,0.483,0.538,9,10,0.9,8,42,50,67,16,2,18,29,94,202
Brandon Ingram,SF,26,NOP,17,17,576,156,318,0.491,22,76,0.289,134,242,0.554,0.525,64,80,0.8,9,78,87,89,11,3,45,36,398,203
Kyrie Irving,SG,31,DAL,15,15,500,131,288,0.455,39,105,0.371,92,183,0.503,0.523,53,59,0.898,10,52,62,82,16,5,22,28,354,204
Jonathan Isaac,PF,26,ORL,15,0,201,32,73,0.438,8,35,0.229,24,38,0.632,0.493,23,29,0.793,18,49,67,5,13,19,10,21,95,205
Jaden Ivey,SG,21,DET,15,5,340,63,124,0.508,17,46,0.37,46,78,0.59,0.577,34,43,0.791,13,28,41,46,11,6,32,42,177,206
Andre Jackson Jr.,SG,22,MIL,15,3,129,14,22,0.636,6,11,0.545,8,11,0.727,0.773,0,0,,10,10,20,11,5,0,8,23,34,207
Isaiah Jackson,C,22,IND,10,0,132,16,31,0.516,0,1,0.0,16,30,0.533,0.516,14,21,0.667,16,26,42,9,5,18,5,32,46,209
Jaren Jackson Jr.,C,24,MEM,18,18,549,112,275,0.407,24,87,0.276,88,188,0.468,0.451,87,106,0.821,33,75,108,34,10,33,33,62,335,210
Reggie Jackson,PG,33,DEN,20,12,531,107,210,0.51,33,80,0.413,74,130,0.569,0.588,18,28,0.643,8,42,50,87,15,7,33,39,265,211
Trayce Jackson-Davis,PF,23,GSW,13,0,102,12,22,0.545,0,0,,12,22,0.545,0.545,15,25,0.6,11,12,23,6,2,7,6,18,39,212
LeBron James,PF,39,LAL,19,19,636,176,315,0.559,44,111,0.396,132,204,0.647,0.629,76,108,0.704,16,132,148,120,26,14,68,21,472,213
Jaime Jaquez Jr.,SF,22,MIA,19,4,505,92,174,0.529,23,59,0.39,69,115,0.6,0.595,21,24,0.875,23,51,74,48,20,4,29,45,228,214
DaQuan Jeffries,SG,26,NYK,7,0,19,3,8,0.375,1,4,0.25,2,4,0.5,0.438,0,2,0.0,0,3,3,1,0,0,1,1,7,215
Ty Jerome,SG,26,CLE,2,0,15,2,4,0.5,0,1,0.0,2,3,0.667,0.5,0,0,,1,0,1,3,0,0,1,2,4,216
Isaiah Joe,SG,24,OKC,18,0,372,63,136,0.463,50,108,0.463,13,28,0.464,0.647,20,24,0.833,1,40,41,21,16,6,9,22,196,217
Cameron Johnson,PF,27,BRK,11,11,320,61,135,0.452,26,71,0.366,35,64,0.547,0.548,19,22,0.864,21,43,64,32,10,1,17,19,167,218
Jalen Johnson,SF,22,ATL,15,12,449,85,143,0.594,17,40,0.425,68,103,0.66,0.654,25,33,0.758,20,89,109,36,17,15,30,33,212,219
Keldon Johnson,SF,24,SAS,18,18,591,112,237,0.473,35,98,0.357,77,139,0.554,0.546,39,54,0.722,21,96,117,74,14,5,23,45,298,220
Nikola Jokic,C,28,DEN,19,19,642,214,377,0.568,24,79,0.304,190,298,0.638,0.599,91,116,0.784,63,179,242,182,22,15,58,48,543,222
Colby Jones,SG,21,SAC,9,0,70,13,28,0.464,1,8,0.125,12,20,0.6,0.482,2,3,0.667,6,8,14,2,2,1,4,9,29,223
Damian Jones,C,28,CLE,10,0,51,4,8,0.5,0,0,,4,8,0.5,0.5,1,2,0.5,4,6,10,3,1,2,3,3,9,224
Derrick Jones Jr.,SF,26,DAL,18,17,412,59,123,0.48,28,70,0.4,31,53,0.585,0.593,17,23,0.739,20,45,65,18,10,12,16,27,163,225
Herbert Jones,SF,25,NOP,17,17,525,68,130,0.523,21,58,0.362,47,72,0.653,0.604,39,45,0.867,13,55,68,46,31,22,28,60,196,226
Tre Jones,PG,24,SAS,16,0,383,48,113,0.425,10,35,0.286,38,78,0.487,0.469,20,23,0.87,10,37,47,81,12,4,24,20,126,227
Tyus Jones,PG,27,WAS,19,19,509,88,179,0.492,21,60,0.35,67,119,0.563,0.55,9,13,0.692,6,47,53,93,18,2,12,18,206,228
DeAndre Jordan,C,35,DEN,5,1,77,13,16,0.813,0,0,,13,16,0.813,0.813,6,19,0.316,6,17,23,7,2,1,6,10,32,229
Cory Joseph,PG,32,GSW,9,0,93,6,23,0.261,4,16,0.25,2,7,0.286,0.348,4,7,0.571,2,7,9,18,3,1,5,8,20,230
Luke Kennard,SG,27,MEM,8,0,172,21,58,0.362,17,46,0.37,4,12,0.333,0.509,7,7,1.0,3,20,23,16,5,1,5,4,66,232
Walker Kessler,C,22,UTA,12,8,293,47,87,0.54,2,11,0.182,45,76,0.592,0.552,11,19,0.579,37,58,95,9,3,30,13,27,107,233
Corey Kispert,SF,24,WAS,18,1,412,66,148,0.446,35,94,0.372,31,54,0.574,0.564,29,37,0.784,9,37,46,29,8,0,17,32,196,235
Maxi Kleber,C,32,DAL,5,1,90,4,16,0.25,3,9,0.333,1,7,0.143,0.344,6,10,0.6,4,17,21,10,1,1,4,8,17,236
John Konchar,SF,27,MEM,14,2,245,15,43,0.349,8,25,0.32,7,18,0.389,0.442,1,2,0.5,15,40,55,22,8,9,4,16,39,238
Furkan Korkmaz,SG,26,PHI,14,0,103,11,30,0.367,4,15,0.267,7,15,0.467,0.433,5,7,0.714,1,7,8,6,9,0,6,7,31,239
Luke Kornet,C,28,BOS,14,0,184,26,32,0.813,0,0,,26,32,0.813,0.813,8,10,0.8,17,30,47,7,7,9,5,17,60,240
Jonathan Kuminga,PF,21,GSW,18,1,360,73,161,0.453,10,41,0.244,63,120,0.525,0.484,47,68,0.691,14,41,55,19,10,7,25,43,203,241
Kyle Kuzma,PF,28,WAS,19,19,594,174,367,0.474,44,123,0.358,130,244,0.533,0.534,56,68,0.824,18,97,115,88,6,12,47,38,448,242
Jock Landale,C,28,HOU,12,0,110,9,26,0.346,2,10,0.2,7,16,0.438,0.385,4,4,1.0,9,14,23,8,4,2,8,9,24,243
Jake LaRavia,PF,22,MEM,5,0,61,7,20,0.35,2,12,0.167,5,8,0.625,0.4,1,2,0.5,3,5,8,2,1,0,2,8,17,244
Zach LaVine,SG,28,CHI,18,18,635,132,298,0.443,43,128,0.336,89,170,0.524,0.515,71,82,0.866,6,82,88,61,17,4,36,37,378,245
Alex Len,C,30,SAC,6,0,41,6,8,0.75,0,1,0.0,6,7,0.857,0.75,3,7,0.429,7,9,16,5,1,5,2,2,15,248
Kawhi Leonard,SF,32,LAC,18,18,614,146,308,0.474,39,99,0.394,107,209,0.512,0.537,63,76,0.829,17,89,106,58,30,13,26,28,394,249
Caris LeVert,SG,29,CLE,16,1,486,87,213,0.408,27,87,0.31,60,126,0.476,0.472,37,50,0.74,7,52,59,57,16,6,22,29,238,250
Kira Lewis Jr.,PG,22,NOP,11,0,121,14,43,0.326,2,15,0.133,12,28,0.429,0.349,8,9,0.889,3,7,10,18,5,1,5,8,38,251
Maxwell Lewis,SF,21,LAL,9,0,40,0,4,0.0,0,0,,0,4,0.0,0.0,0,0,,1,1,2,2,2,0,4,1,0,252
E.J. Liddell,PF,23,NOP,3,0,9,1,4,0.25,0,3,0.0,1,1,1.0,0.25,2,2,1.0,0,2,2,0,0,1,1,1,4,253
Damian Lillard,PG,33,MIL,17,17,592,122,292,0.418,48,146,0.329,74,146,0.507,0.5,142,154,0.922,12,64,76,116,18,2,46,22,434,254
Nassir Little,PF,23,PHO,13,0,196,26,51,0.51,10,30,0.333,16,21,0.762,0.608,12,14,0.857,6,23,29,7,9,7,4,18,74,255
Dereck Lively II,C,19,DAL,16,15,387,56,81,0.691,0,2,0.0,56,79,0.709,0.691,14,22,0.636,45,72,117,21,9,19,17,52,126,256
Isaiah Livers,PF,25,DET,5,1,121,14,39,0.359,9,26,0.346,5,13,0.385,0.474,5,7,0.714,4,10,14,7,1,0,8,9,42,257
Chris Livingston,SF,20,MIL,2,0,9,2,2,1.0,1,1,1.0,1,1,1.0,1.25,0,0,,0,0,0,1,0,0,0,0,5,258
Kenneth Lofton Jr.,PF,21,MEM,13,0,94,13,34,0.382,2,8,0.25,11,26,0.423,0.412,6,13,0.462,2,12,14,12,2,3,6,15,34,259
Kevon Looney,C,27,GSW,19,17,446,45,79,0.57,0,0,,45,79,0.57,0.57,18,25,0.72,58,107,165,53,15,6,18,54,108,260
Brook Lopez,C,35,MIL,19,19,562,98,192,0.51,36,98,0.367,62,94,0.66,0.604,26,31,0.839,26,70,96,23,16,51,17,45,258,261
Robin Lopez,C,35,MIL,3,0,9,0,0,,0,0,,0,0,,,2,2,1.0,0,0,0,1,0,0,1,2,2,262
Kevin Love,PF,35,MIA,13,4,229,29,79,0.367,17,55,0.309,12,24,0.5,0.475,21,26,0.808,15,75,90,30,2,0,8,23,96,263
Kyle Lowry,PG,37,MIA,18,18,528,59,129,0.457,40,87,0.46,19,42,0.452,0.612,16,18,0.889,16,56,72,80,23,5,25,52,174,264
Trey Lyles,PF,28,SAC,4,0,88,10,25,0.4,7,20,0.35,3,5,0.6,0.54,7,12,0.583,6,20,26,2,0,1,7,10,34,265
Sandro Mamukelashvili,C,24,SAS,7,0,55,6,15,0.4,2,7,0.286,4,8,0.5,0.467,5,6,0.833,6,7,13,8,2,1,3,8,19,267
Terance Mann,SG,27,LAC,12,8,322,34,75,0.453,5,30,0.167,29,45,0.644,0.487,8,13,0.615,15,34,49,26,10,5,9,25,81,268
Tre Mann,PG,22,OKC,6,0,47,10,18,0.556,3,8,0.375,7,10,0.7,0.639,1,1,1.0,3,9,12,8,1,0,5,1,24,269
Boban Marjanovic,C,35,HOU,3,0,20,5,9,0.556,0,1,0.0,5,8,0.625,0.556,0,1,0.0,2,6,8,3,0,1,0,2,10,270
Lauri Markkanen,PF,26,UTA,15,15,512,122,252,0.484,49,128,0.383,73,124,0.589,0.581,63,75,0.84,36,94,130,16,17,13,20,34,356,271
Naji Marshall,SF,26,NOP,11,0,236,34,71,0.479,14,31,0.452,20,40,0.5,0.577,22,27,0.815,14,40,54,25,9,4,15,15,104,272
Caleb Martin,SF,28,MIA,9,0,194,32,81,0.395,8,30,0.267,24,51,0.471,0.444,9,11,0.818,9,20,29,14,9,0,9,16,81,273
KJ Martin,SF,23,TOT,11,0,85,8,22,0.364,1,6,0.167,7,16,0.438,0.386,3,6,0.5,3,9,12,4,5,1,5,14,20,274
Garrison Mathews,SG,27,ATL,6,0,40,4,11,0.364,4,11,0.364,0,0,,0.545,0,0,,1,5,6,1,1,0,0,3,12,275
Bennedict Mathurin,SF,21,IND,17,12,418,81,182,0.445,18,55,0.327,63,127,0.496,0.495,38,49,0.776,19,43,62,31,11,3,20,31,218,276
Wesley Matthews,SG,37,ATL,8,0,83,6,15,0.4,5,14,0.357,1,1,1.0,0.567,3,6,0.5,2,7,9,7,1,1,2,12,20,277
Tyrese Maxey,PG,23,PHI,18,18,691,169,364,0.464,59,149,0.396,110,215,0.512,0.545,89,99,0.899,12,71,83,120,15,12,28,34,486,278
Miles McBride,PG,23,NYK,12,0,54,8,17,0.471,4,13,0.308,4,4,1.0,0.588,1,2,0.5,1,2,3,3,4,0,0,7,21,280
CJ McCollum,PG,32,NOP,8,8,272,59,134,0.44,23,66,0.348,36,68,0.529,0.526,28,36,0.778,7,29,36,47,13,7,11,18,169,281
T.J. McConnell,PG,31,IND,11,0,154,31,59,0.525,1,6,0.167,30,53,0.566,0.534,10,14,0.714,7,21,28,41,8,2,10,16,73,282
Jaden McDaniels,SF,23,MIN,11,11,260,46,79,0.582,11,29,0.379,35,50,0.7,0.652,2,2,1.0,7,17,24,14,6,4,11,36,105,283
Jalen McDaniels,SF,26,TOR,15,0,138,13,46,0.283,4,22,0.182,9,24,0.375,0.326,2,2,1.0,4,14,18,9,5,3,6,13,32,284
Doug McDermott,SF,32,SAS,17,0,283,38,79,0.481,28,59,0.475,10,20,0.5,0.658,4,6,0.667,3,16,19,31,6,2,12,22,108,285
JaVale McGee,C,36,SAC,15,0,145,36,54,0.667,0,1,0.0,36,53,0.679,0.667,11,19,0.579,22,35,57,7,4,8,17,17,83,286
Bryce McGowens,SG,21,CHO,12,1,189,19,42,0.452,13,29,0.448,6,13,0.462,0.607,8,10,0.8,4,20,24,11,6,2,7,17,59,287
Jordan McLaughlin,PG,27,MIN,5,0,19,1,4,0.25,1,2,0.5,0,2,0.0,0.375,2,2,1.0,0,0,0,5,0,2,0,2,5,288
De'Anthony Melton,SG,25,PHI,19,19,574,79,199,0.397,46,115,0.4,33,84,0.393,0.513,40,51,0.784,16,60,76,70,25,8,27,51,244,289
Sam Merrill,SG,27,CLE,9,0,73,8,24,0.333,8,21,0.381,0,3,0.0,0.5,0,0,,2,4,6,5,2,0,2,5,24,290
Chimezie Metu,C,26,PHO,11,0,78,11,22,0.5,3,9,0.333,8,13,0.615,0.568,3,4,0.75,2,13,15,4,1,3,3,13,28,291
Vasilije Micic,PG,30,OKC,8,0,98,9,24,0.375,5,14,0.357,4,10,0.4,0.479,4,6,0.667,0,4,4,22,1,0,10,6,27,292
Khris Middleton,SF,32,MIL,15,15,308,67,147,0.456,18,57,0.316,49,90,0.544,0.517,25,32,0.781,11,51,62,59,11,1,25,30,177,293
Brandon Miller,SF,21,CHO,15,9,461,83,179,0.464,25,67,0.373,58,112,0.518,0.534,25,32,0.781,19,41,60,29,10,6,18,45,216,294
Leonard Miller,SF,20,MIN,3,0,6,1,2,0.5,0,0,,1,2,0.5,0.5,0,0,,0,6,6,1,0,0,0,1,2,296
Dariq Whitehead,SF,19,BRK,1,0,3,0,0,,0,0,,0,0,,,1,2,0.5,0,0,0,0,0,1,0,0,1,297
Patty Mills,PG,35,ATL,1,0,5,1,2,0.5,1,1,1.0,0,1,0.0,0.75,0,0,,0,1,1,0,0,0,0,0,3,298
Shake Milton,SG,27,MIN,18,0,287,33,89,0.371,8,35,0.229,25,54,0.463,0.416,26,33,0.788,4,32,36,27,13,3,20,28,100,299
Josh Minott,SF,21,MIN,9,0,23,6,12,0.5,0,5,0.0,6,7,0.857,0.5,2,4,0.5,1,2,3,1,0,1,0,4,14,301
Davion Mitchell,PG,25,SAC,14,3,237,25,69,0.362,12,41,0.293,13,28,0.464,0.449,9,9,1.0,1,16,17,37,5,2,13,23,71,302
Donovan Mitchell,SG,27,CLE,14,14,499,134,296,0.453,41,120,0.342,93,176,0.528,0.522,78,86,0.907,15,62,77,74,29,7,34,27,387,303
Evan Mobley,PF,22,CLE,19,19,632,132,231,0.571,2,10,0.2,130,221,0.588,0.576,48,62,0.774,54,150,204,58,16,34,42,52,314,304
Malik Monk,SG,25,SAC,17,0,412,73,181,0.403,41,102,0.402,32,79,0.405,0.517,47,53,0.887,10,39,49,78,11,9,37,30,234,306
Moses Moody,SG,21,GSW,19,3,344,58,115,0.504,22,59,0.373,36,56,0.643,0.6,14,21,0.667,21,42,63,21,14,6,11,24,152,307
Wendell Moore Jr.,SG,22,MIN,1,0,2,0,1,0.0,0,1,0.0,0,0,,0.0,0,0,,0,0,0,0,0,0,0,0,0,308
Markieff Morris,PF,34,DAL,3,0,23,3,13,0.231,2,8,0.25,1,5,0.2,0.308,0,0,,2,2,4,2,0,0,0,2,8,310
Trey Murphy III,SF,23,NOP,1,0,22,7,13,0.538,4,10,0.4,3,3,1.0,0.692,0,0,,1,2,3,1,1,1,0,0,18,311
Dejounte Murray,SG,27,ATL,18,18,615,134,300,0.447,40,106,0.377,94,194,0.485,0.513,49,57,0.86,13,63,76,94,32,5,43,26,357,312
Jamal Murray,PG,26,DEN,8,8,238,46,111,0.414,17,40,0.425,29,71,0.408,0.491,21,24,0.875,3,21,24,58,2,5,16,15,130,313
Keegan Murray,SF,23,SAC,13,13,430,64,164,0.39,27,94,0.287,37,70,0.529,0.473,17,20,0.85,24,56,80,26,18,8,15,31,172,314
Kris Murray,SF,23,POR,10,0,88,6,20,0.3,3,12,0.25,3,8,0.375,0.375,3,5,0.6,4,4,8,3,5,1,1,8,18,315
Mike Muscala,C,32,WAS,7,1,82,8,19,0.421,3,10,0.3,5,9,0.556,0.5,4,4,1.0,2,17,19,8,1,3,7,7,23,316
Svi Mykhailiuk,SF,26,BOS,8,0,59,6,17,0.353,4,14,0.286,2,3,0.667,0.471,0,0,,1,4,5,1,3,0,4,4,16,317
Larry Nance Jr.,C,31,NOP,14,0,211,21,42,0.5,3,11,0.273,18,31,0.581,0.536,4,8,0.5,18,40,58,10,9,4,13,19,49,318
Andrew Nembhard,PG,24,IND,14,1,266,47,98,0.48,9,33,0.273,38,65,0.585,0.526,3,5,0.6,9,18,27,56,13,0,22,31,106,319
Aaron Nesmith,SF,24,IND,15,1,351,57,108,0.528,25,57,0.439,32,51,0.627,0.644,17,26,0.654,15,34,49,15,17,8,9,49,156,320
Georges Niang,PF,30,CLE,19,1,424,57,142,0.401,30,85,0.353,27,57,0.474,0.507,11,11,1.0,6,70,76,22,7,2,11,45,155,321
Daishen Nix,PG,21,MIN,5,0,20,3,8,0.375,2,5,0.4,1,3,0.333,0.5,0,0,,0,1,1,0,1,0,0,0,8,322
Zeke Nnaji,PF,23,DEN,19,0,199,25,51,0.49,3,7,0.429,22,44,0.5,0.52,17,28,0.607,23,21,44,8,3,10,10,26,70,323
Jusuf Nurkic,C,29,PHO,19,19,531,83,172,0.483,13,47,0.277,70,125,0.56,0.52,49,66,0.742,55,119,174,74,19,25,41,67,228,326
Jordan Nwora,SF,25,IND,5,0,73,14,34,0.412,4,15,0.267,10,19,0.526,0.471,3,4,0.75,6,9,15,6,4,1,7,8,35,327
Royce O'Neale,SF,30,BRK,17,5,508,49,128,0.383,44,108,0.407,5,20,0.25,0.555,2,6,0.333,12,80,92,55,14,15,18,53,144,328
Chuma Okeke,SF,25,ORL,8,0,32,4,11,0.364,3,8,0.375,1,3,0.333,0.5,0,0,,3,4,7,3,0,0,1,0,11,329
Josh Okogie,SG,25,PHO,19,8,416,41,96,0.427,11,42,0.262,30,54,0.556,0.484,44,52,0.846,32,34,66,21,16,9,17,25,137,330
Onyeka Okongwu,C,23,ATL,18,0,415,59,103,0.573,5,19,0.263,54,84,0.643,0.597,40,45,0.889,47,75,122,24,10,15,15,49,163,331
Isaac Okoro,SF,23,CLE,10,5,235,28,57,0.491,7,18,0.389,21,39,0.538,0.553,10,15,0.667,14,20,34,15,8,6,9,25,73,332
Kelly Olynyk,C,32,UTA,19,1,400,50,86,0.581,16,34,0.471,34,52,0.654,0.674,29,33,0.879,36,69,105,71,16,4,37,55,145,333
Eugene Omoruyi,SF,26,WAS,11,0,75,23,36,0.639,5,11,0.455,18,25,0.72,0.708,12,16,0.75,9,12,21,8,5,1,6,10,63,334
Cedi Osman,SF,28,SAS,19,0,369,58,126,0.46,29,73,0.397,29,53,0.547,0.575,11,14,0.786,9,29,38,28,8,4,12,33,156,335
Kelly Oubre Jr.,SF,28,PHI,8,5,232,47,94,0.5,14,37,0.378,33,57,0.579,0.574,22,28,0.786,11,30,41,5,11,3,7,19,130,336
Chris Paul,PG,38,GSW,18,7,483,57,143,0.399,21,64,0.328,36,79,0.456,0.472,26,28,0.929,5,60,65,131,27,1,20,29,161,337
Cameron Payne,PG,29,MIL,19,2,325,41,88,0.466,24,52,0.462,17,36,0.472,0.602,6,6,1.0,1,24,25,45,8,2,15,38,112,338
Gary Payton II,SG,31,GSW,14,0,242,34,71,0.479,9,28,0.321,25,43,0.581,0.542,6,9,0.667,15,29,44,13,17,4,9,26,83,339
Filip Petrusev,C,23,TOT,3,0,10,1,2,0.5,0,0,,1,2,0.5,0.5,1,2,0.5,0,1,1,0,0,0,0,1,3,340
Julian Phillips,SF,20,CHI,9,0,45,2,12,0.167,0,6,0.0,2,6,0.333,0.167,1,4,0.25,1,6,7,4,0,0,1,6,5,341
Jalen Pickett,SG,24,DEN,11,0,74,9,20,0.45,5,14,0.357,4,6,0.667,0.575,2,2,1.0,1,9,10,7,3,0,6,7,25,342
Mason Plumlee,C,33,LAC,6,0,102,12,19,0.632,0,0,,12,19,0.632,0.632,6,14,0.429,8,25,33,6,4,1,5,6,30,343
Brandin Podziemski,SG,20,GSW,13,0,226,33,74,0.446,13,31,0.419,20,43,0.465,0.534,11,15,0.733,13,41,54,28,6,0,13,21,90,344
Jakob Poeltl,C,28,TOR,20,20,533,105,144,0.729,0,0,,105,144,0.729,0.729,17,35,0.486,56,114,170,46,17,21,34,55,227,345
Aleksej Pokusevski,PF,22,OKC,6,0,34,2,9,0.222,1,6,0.167,1,3,0.333,0.278,1,2,0.5,2,5,7,5,0,1,3,5,6,346
Jordan Poole,SG,24,WAS,18,18,529,108,276,0.391,34,119,0.286,74,157,0.471,0.453,59,69,0.855,9,41,50,63,21,7,51,58,309,347
Michael Porter Jr.,SF,25,DEN,20,20,629,135,284,0.475,60,155,0.387,75,129,0.581,0.581,23,31,0.742,35,126,161,35,11,15,24,47,353,349
Otto Porter Jr.,SF,30,TOR,9,1,110,10,23,0.435,7,16,0.438,3,7,0.429,0.587,1,1,1.0,6,16,22,1,3,3,1,10,28,350
Bobby Portis,PF,28,MIL,19,0,456,86,183,0.47,14,47,0.298,72,136,0.529,0.508,25,33,0.758,24,99,123,24,17,10,18,43,211,351
Kristaps Porzingis,C,28,BOS,15,15,454,98,179,0.547,24,74,0.324,74,105,0.705,0.615,64,80,0.8,22,78,100,28,10,25,19,51,284,352
Dwight Powell,C,32,DAL,16,1,238,21,29,0.724,1,1,1.0,20,28,0.714,0.741,28,36,0.778,21,30,51,22,5,8,6,28,71,353
Norman Powell,SG,30,LAC,18,0,422,71,146,0.486,33,71,0.465,38,75,0.507,0.599,40,49,0.816,3,32,35,19,13,9,18,38,215,354
Taurean Prince,PF,29,LAL,18,18,539,58,142,0.408,26,80,0.325,32,62,0.516,0.5,12,16,0.75,6,34,40,27,10,8,12,43,154,355
Payton Pritchard,PG,26,BOS,19,0,395,45,115,0.391,24,72,0.333,21,43,0.488,0.496,10,13,0.769,19,41,60,56,7,0,11,20,124,356
Olivier-Maxence Prosper,PF,21,DAL,8,0,52,4,14,0.286,1,9,0.111,3,5,0.6,0.321,6,10,0.6,2,7,9,3,1,0,0,3,15,357
Neemias Queta,C,24,BOS,3,0,31,4,10,0.4,0,0,,4,10,0.4,0.4,4,5,0.8,8,9,17,0,1,0,2,2,12,358
Immanuel Quickley,SG,24,NYK,19,0,464,100,229,0.437,39,106,0.368,61,123,0.496,0.522,53,60,0.883,4,55,59,54,9,2,22,31,292,359
Julius Randle,PF,29,NYK,19,19,664,136,330,0.412,31,111,0.279,105,219,0.479,0.459,85,121,0.702,40,153,193,105,14,3,60,49,388,361
Austin Reaves,SG,25,LAL,20,8,598,94,204,0.461,25,79,0.316,69,125,0.552,0.522,57,67,0.851,18,76,94,98,19,2,49,29,270,363
Cam Reddish,SF,24,LAL,16,9,379,38,93,0.409,15,46,0.326,23,47,0.489,0.489,20,25,0.8,7,34,41,18,25,4,10,25,111,364
Paul Reed,C,24,PHI,19,1,280,47,79,0.595,4,9,0.444,43,70,0.614,0.62,6,8,0.75,34,49,83,20,10,12,16,40,104,365
Naz Reid,C,24,MIN,18,0,382,80,159,0.503,29,74,0.392,51,85,0.6,0.594,27,30,0.9,16,55,71,11,13,11,19,28,216,366
Nick Richards,C,26,CHO,11,0,192,33,42,0.786,0,0,,33,42,0.786,0.786,27,34,0.794,17,48,65,4,4,13,13,32,93,368
Josh Richardson,SG,30,MIA,16,4,446,61,136,0.449,19,67,0.284,42,69,0.609,0.518,22,25,0.88,9,34,43,50,10,4,18,29,163,369
Duncan Robinson,SF,29,MIA,17,9,501,87,181,0.481,53,120,0.442,34,61,0.557,0.627,20,24,0.833,4,40,44,46,6,3,16,40,247,370
Mitchell Robinson,C,25,NYK,19,19,567,52,90,0.578,0,0,,52,90,0.578,0.578,14,36,0.389,106,98,204,10,29,26,18,36,118,372
Orlando Robinson,C,23,MIA,5,0,67,11,20,0.55,2,2,1.0,9,18,0.5,0.6,3,4,0.75,6,13,19,9,2,3,5,10,27,373
Jeremiah Robinson-Earl,PF,23,NOP,7,1,98,13,25,0.52,6,11,0.545,7,14,0.5,0.64,6,6,1.0,8,14,22,5,2,0,6,9,38,374
David Roddy,PF,22,MEM,18,3,421,61,141,0.433,17,59,0.288,44,82,0.537,0.493,12,17,0.706,18,55,73,20,11,8,16,29,151,375
Ryan Rollins,PG,21,WAS,8,0,49,9,18,0.5,1,2,0.5,8,16,0.5,0.528,13,16,0.813,2,8,10,10,8,2,7,6,32,376
Derrick Rose,PG,35,MEM,10,2,190,39,83,0.47,8,21,0.381,31,62,0.5,0.518,11,13,0.846,6,14,20,31,5,1,12,11,97,377
Terry Rozier,SG,29,CHO,8,8,289,69,146,0.473,17,47,0.362,52,99,0.525,0.531,25,31,0.806,4,23,27,52,7,3,22,9,180,378
Rayan Rupert,SG,19,POR,7,0,31,1,12,0.083,1,6,0.167,0,6,0.0,0.125,2,4,0.5,1,0,1,2,2,0,2,1,5,379
D'Angelo Russell,PG,27,LAL,20,20,622,131,267,0.491,46,110,0.418,85,157,0.541,0.577,43,55,0.782,8,61,69,131,12,12,38,40,351,380
Domantas Sabonis,C,27,SAC,17,17,595,121,206,0.587,9,21,0.429,112,185,0.605,0.609,67,103,0.65,58,140,198,118,14,15,53,60,318,382
Luka Samanic,PF,24,UTA,8,0,43,8,19,0.421,3,9,0.333,5,10,0.5,0.5,1,1,1.0,2,11,13,2,1,1,4,2,20,383
Dario Saric,C,29,GSW,19,3,413,71,156,0.455,32,83,0.386,39,73,0.534,0.558,32,38,0.842,30,85,115,46,13,6,18,45,206,386
Marcus Sasser,PG,23,DET,19,0,355,63,136,0.463,27,66,0.409,36,70,0.514,0.563,9,9,1.0,3,34,37,56,14,3,14,29,162,388
Dennis Schroder,PG,30,TOR,20,20,632,113,260,0.435,36,102,0.353,77,158,0.487,0.504,55,64,0.859,10,50,60,140,18,2,35,39,317,390
Alperen Sengun,C,21,HOU,16,16,522,139,247,0.563,12,39,0.308,127,208,0.611,0.587,46,69,0.667,42,101,143,89,14,11,43,51,336,392
Brice Sensabaugh,SF,20,UTA,1,0,2,0,2,0.0,0,0,,0,2,0.0,0.0,0,0,,1,1,2,0,0,0,0,0,0,393
Collin Sexton,SG,25,UTA,19,0,383,76,175,0.434,23,66,0.348,53,109,0.486,0.5,51,59,0.864,17,31,48,59,8,4,38,32,226,394
Landry Shamet,SG,26,WAS,15,0,253,48,101,0.475,24,60,0.4,24,41,0.585,0.594,5,11,0.455,2,19,21,22,9,2,9,31,125,395
Day'Ron Sharpe,C,22,BRK,18,0,275,47,84,0.56,0,4,0.0,47,80,0.588,0.56,25,38,0.658,42,74,116,13,7,12,19,38,119,396
Shaedon Sharpe,SG,20,POR,18,17,660,108,263,0.411,34,101,0.337,74,162,0.457,0.475,61,73,0.836,27,74,101,60,19,8,58,53,311,397
Ben Sheppard,SG,22,IND,8,0,55,9,22,0.409,5,15,0.333,4,7,0.571,0.523,2,2,1.0,1,4,5,5,1,0,1,4,25,398
Pascal Siakam,PF,29,TOR,20,20,686,154,323,0.477,16,81,0.198,138,242,0.57,0.502,76,102,0.745,33,110,143,100,15,4,53,46,400,399
Ben Simmons,PG,27,BRK,6,6,191,19,36,0.528,0,0,,19,36,0.528,0.528,1,4,0.25,16,49,65,40,3,5,15,16,39,400
Anfernee Simons,SG,24,POR,1,1,27,6,14,0.429,2,6,0.333,4,8,0.5,0.5,4,4,1.0,1,1,2,4,2,0,0,2,18,401
Jericho Sims,C,25,NYK,8,0,22,2,3,0.667,0,0,,2,3,0.667,0.667,1,3,0.333,1,9,10,1,0,0,0,1,5,402
Marcus Smart,PG,29,MEM,11,11,329,51,119,0.429,18,61,0.295,33,58,0.569,0.504,17,21,0.81,3,24,27,55,22,4,37,35,137,404
Dennis Smith Jr.,PG,26,BRK,11,0,187,25,63,0.397,7,19,0.368,18,44,0.409,0.452,7,8,0.875,8,17,25,35,7,2,11,25,64,405
Dru Smith,SG,26,MIA,9,0,131,15,33,0.455,7,17,0.412,8,16,0.5,0.561,2,2,1.0,6,8,14,14,9,3,5,12,39,406
Jabari Smith Jr.,PF,20,HOU,16,16,483,86,171,0.503,29,78,0.372,57,93,0.613,0.588,15,21,0.714,24,100,124,22,9,11,19,52,216,408
Jalen Smith,C,23,IND,14,0,216,53,75,0.707,14,21,0.667,39,54,0.722,0.8,20,27,0.741,20,57,77,12,5,4,15,29,140,409
Nick Smith Jr.,SG,19,CHO,8,0,57,12,25,0.48,8,12,0.667,4,13,0.308,0.64,0,0,,2,3,5,2,1,2,2,5,32,410
Jeremy Sochan,PG,20,SAS,19,19,551,85,190,0.447,18,42,0.429,67,148,0.453,0.495,34,43,0.791,28,74,102,84,14,4,46,56,222,411
Jaden Springer,SG,21,PHI,11,0,127,13,37,0.351,3,12,0.25,10,25,0.4,0.392,6,8,0.75,12,10,22,10,5,6,12,18,35,412
Lamar Stevens,PF,26,BOS,6,0,20,4,7,0.571,1,1,1.0,3,6,0.5,0.643,0,0,,4,2,6,2,1,1,3,4,9,413
Isaiah Stewart,PF,22,DET,19,19,595,79,176,0.449,29,76,0.382,50,100,0.5,0.531,25,32,0.781,38,98,136,23,5,14,32,48,212,414
Julian Strawther,SF,21,DEN,17,0,215,33,86,0.384,19,57,0.333,14,29,0.483,0.494,6,8,0.75,1,20,21,16,5,5,3,28,91,415
Max Strus,SF,27,CLE,19,19,667,96,223,0.43,54,143,0.378,42,80,0.525,0.552,19,23,0.826,14,91,105,75,19,13,31,50,265,416
Jalen Suggs,SG,22,ORL,18,18,489,81,178,0.455,30,81,0.37,51,97,0.526,0.539,44,54,0.815,13,56,69,50,35,10,36,52,236,417
Jae'Sean Tate,SF,28,HOU,15,0,282,36,71,0.507,11,31,0.355,25,40,0.625,0.585,8,10,0.8,16,42,58,20,17,5,5,42,91,419
Jayson Tatum,PF,25,BOS,19,19,694,181,363,0.499,59,163,0.362,122,200,0.61,0.58,99,123,0.805,13,152,165,77,21,7,65,42,520,420
Terry Taylor,PF,24,CHI,5,0,12,1,1,1.0,0,0,,1,1,1.0,1.0,0,0,,0,1,1,0,1,0,0,0,2,421
Garrett Temple,SG,37,TOR,5,0,16,4,5,0.8,1,1,1.0,3,4,0.75,0.9,2,2,1.0,0,2,2,2,1,0,0,0,11,422
Dalen Terry,SG,21,CHI,6,0,23,3,9,0.333,1,4,0.25,2,5,0.4,0.389,0,2,0.0,2,8,10,4,0,1,1,2,7,423
Daniel Theis,C,31,TOT,9,0,141,25,55,0.455,3,7,0.429,22,48,0.458,0.482,5,10,0.5,15,19,34,11,2,6,5,23,58,424
Cam Thomas,SG,22,BRK,9,7,284,90,186,0.484,19,58,0.328,71,128,0.555,0.535,42,50,0.84,2,30,32,18,7,6,11,16,241,425
Amen Thompson,SF,21,HOU,4,0,67,9,22,0.409,2,11,0.182,7,11,0.636,0.455,5,8,0.625,1,10,11,6,2,1,6,9,25,426
Ausar Thompson,SF,21,DET,19,18,549,87,187,0.465,5,35,0.143,82,152,0.539,0.479,30,43,0.698,59,115,174,53,20,29,41,70,209,427
Klay Thompson,SF,33,GSW,18,18,534,98,241,0.407,49,136,0.36,49,105,0.467,0.508,37,42,0.881,11,56,67,41,7,11,36,41,282,428
Tristan Thompson,PF,32,CLE,14,0,130,15,21,0.714,0,0,,15,21,0.714,0.714,5,13,0.385,16,19,35,11,2,5,7,13,35,429
JT Thor,PF,21,CHO,17,1,280,26,62,0.419,12,33,0.364,14,29,0.483,0.516,0,4,0.0,14,35,49,10,4,5,4,21,64,430
Matisse Thybulle,SF,26,POR,18,9,398,40,84,0.476,25,66,0.379,15,18,0.833,0.625,6,8,0.75,6,22,28,20,26,13,14,21,111,431
Xavier Tillman,C,25,MEM,8,5,202,29,70,0.414,7,23,0.304,22,47,0.468,0.464,4,9,0.444,14,35,49,19,13,8,10,20,69,432
Obi Toppin,PF,25,IND,17,16,413,87,146,0.596,18,56,0.321,69,90,0.767,0.658,22,28,0.786,16,37,53,22,12,6,15,31,214,433
Karl-Anthony Towns,PF,28,MIN,18,18,604,142,283,0.502,37,90,0.411,105,193,0.544,0.567,72,79,0.911,18,146,164,54,18,14,53,62,393,434
Gary Trent Jr.,SG,25,TOR,17,2,438,69,173,0.399,32,88,0.364,37,85,0.435,0.491,17,30,0.567,4,30,34,22,14,2,11,18,187,435
P.J. Tucker,PF,38,TOT,15,3,239,6,19,0.316,5,16,0.313,1,3,0.333,0.447,3,3,1.0,16,27,43,8,9,3,4,35,20,436
Myles Turner,C,27,IND,17,17,452,101,201,0.502,24,72,0.333,77,129,0.597,0.562,56,72,0.778,31,99,130,24,11,36,25,59,282,437
Hunter Tyson,PF,23,DEN,7,0,18,1,4,0.25,0,3,0.0,1,1,1.0,0.25,0,0,,0,4,4,1,0,0,0,5,2,438
Jonas Valanciunas,C,31,NOP,20,20,525,109,193,0.565,13,36,0.361,96,157,0.611,0.598,48,59,0.814,47,132,179,49,8,27,25,62,279,440
Fred VanVleet,PG,29,HOU,15,15,564,82,212,0.387,45,123,0.366,37,89,0.416,0.493,33,37,0.892,4,58,62,138,11,7,22,28,242,441
Devin Vassell,SG,23,SAS,14,8,394,92,186,0.495,38,93,0.409,54,93,0.581,0.597,34,43,0.791,6,39,45,38,14,1,21,16,256,442
Sasha Vezenkov,PF,28,SAC,14,0,204,34,77,0.442,19,52,0.365,15,25,0.6,0.565,3,3,1.0,4,28,32,4,6,5,4,18,90,443
Gabe Vincent,PG,27,LAL,4,0,113,11,28,0.393,1,14,0.071,10,14,0.714,0.411,1,2,0.5,2,2,4,12,6,0,2,10,24,444
Nikola Vucevic,C,33,CHI,20,20,687,137,297,0.461,18,69,0.261,119,228,0.522,0.492,30,36,0.833,49,153,202,64,19,11,37,60,322,445
Dean Wade,PF,27,CLE,13,7,264,13,40,0.325,12,38,0.316,1,2,0.5,0.475,2,4,0.5,12,41,53,11,11,3,5,29,40,446
Franz Wagner,SF,22,ORL,19,19,624,147,312,0.471,31,98,0.316,116,214,0.542,0.521,69,83,0.831,23,85,108,65,21,7,34,38,394,447
Moritz Wagner,C,26,ORL,19,0,368,94,149,0.631,11,33,0.333,83,116,0.716,0.668,43,52,0.827,30,54,84,22,9,8,26,47,242,448
Ish Wainright,SF,29,POR,2,0,5,0,1,0.0,0,1,0.0,0,0,,0.0,0,0,,0,0,0,0,1,0,0,1,0,449
Jabari Walker,SF,21,POR,18,0,306,50,109,0.459,10,36,0.278,40,73,0.548,0.505,19,27,0.704,26,60,86,11,14,8,17,42,129,450
Jarace Walker,PF,20,IND,5,0,41,7,18,0.389,0,5,0.0,7,13,0.538,0.389,3,3,1.0,1,7,8,6,2,2,1,4,17,451
Lonnie Walker IV,SG,25,BRK,17,0,362,88,180,0.489,44,95,0.463,44,85,0.518,0.611,29,38,0.763,3,42,45,28,10,7,25,16,249,452
Cason Wallace,SG,20,OKC,18,4,396,49,80,0.613,19,33,0.576,30,47,0.638,0.731,10,11,0.909,9,30,39,26,10,7,10,28,127,453
P.J. Washington,PF,25,CHO,16,12,506,86,200,0.43,30,97,0.309,56,103,0.544,0.505,25,35,0.714,18,67,85,35,11,15,25,45,227,454
TyTy Washington Jr.,PG,22,MIL,2,0,6,1,3,0.333,1,2,0.5,0,1,0.0,0.5,0,0,,0,1,1,0,1,0,2,0,3,455
Yuta Watanabe,SF,29,PHO,14,0,254,23,64,0.359,18,50,0.36,5,14,0.357,0.5,8,11,0.727,8,25,33,8,5,6,11,22,72,456
Lindy Waters III,SG,26,OKC,8,0,62,8,18,0.444,7,17,0.412,1,1,1.0,0.639,0,0,,1,5,6,5,0,1,0,4,23,457
Trendon Watford,PF,23,BRK,12,0,177,34,66,0.515,5,13,0.385,29,53,0.547,0.553,8,9,0.889,13,32,45,22,7,2,15,27,81,458
Peyton Watson,SF,21,DEN,18,0,271,36,72,0.5,4,19,0.211,32,53,0.604,0.528,6,14,0.429,8,27,35,13,9,17,11,25,82,459
Victor Wembanyama,PF,20,SAS,18,18,540,129,295,0.437,26,96,0.271,103,199,0.518,0.481,63,76,0.829,38,136,174,46,24,49,63,46,347,460
Blake Wesley,SG,20,SAS,5,0,24,3,8,0.375,0,1,0.0,3,7,0.429,0.375,1,2,0.5,1,1,2,5,0,1,1,3,7,461
Russell Westbrook,PG,35,LAC,18,10,488,88,202,0.436,12,47,0.255,76,155,0.49,0.465,32,50,0.64,29,91,120,98,25,5,44,46,220,462
Coby White,PG,23,CHI,20,20,656,101,243,0.416,52,136,0.382,49,107,0.458,0.523,30,36,0.833,6,51,57,83,18,6,37,56,284,463
Derrick White,SG,29,BOS,16,16,515,72,154,0.468,35,86,0.407,37,68,0.544,0.581,50,58,0.862,11,51,62,82,17,13,28,36,229,464
Cam Whitmore,SF,19,HOU,4,0,29,6,13,0.462,1,5,0.2,5,8,0.625,0.5,2,4,0.5,0,5,5,1,1,0,2,2,15,465
Aaron Wiggins,SG,25,OKC,16,0,190,29,49,0.592,9,20,0.45,20,29,0.69,0.684,12,17,0.706,9,27,36,13,6,1,9,16,79,466
Andrew Wiggins,SF,28,GSW,18,18,490,91,210,0.433,16,60,0.267,75,150,0.5,0.471,32,54,0.593,35,44,79,21,6,7,32,46,230,467
Grant Williams,PF,25,DAL,18,18,521,61,141,0.433,43,102,0.422,18,39,0.462,0.585,17,27,0.63,21,49,70,31,5,11,17,47,182,469
Jalen Williams,PF,22,OKC,15,15,494,95,187,0.508,15,45,0.333,80,142,0.563,0.548,54,62,0.871,3,58,61,57,11,5,29,46,259,470
Jaylin Williams,C,21,OKC,13,0,174,18,50,0.36,8,28,0.286,10,22,0.455,0.44,5,6,0.833,8,43,51,22,5,2,5,24,49,471
Nate Williams,SG,24,HOU,4,0,22,6,11,0.545,0,2,0.0,6,9,0.667,0.545,1,2,0.5,0,0,0,2,1,0,0,2,13,472
Kenrich Williams,PF,29,OKC,8,0,139,18,33,0.545,7,14,0.5,11,19,0.579,0.652,3,8,0.375,5,16,21,16,4,0,1,19,46,473
Mark Williams,C,22,CHO,17,17,459,92,141,0.652,0,0,,92,141,0.652,0.652,43,60,0.717,72,103,175,21,15,18,15,42,227,474
Patrick Williams,PF,22,CHI,20,10,489,56,141,0.397,20,61,0.328,36,80,0.45,0.468,23,28,0.821,21,56,77,24,19,17,23,29,155,475
Robert Williams III,C,26,POR,6,0,119,17,26,0.654,0,0,,17,26,0.654,0.654,7,9,0.778,11,27,38,5,7,7,7,17,41,476
Ziaire Williams,SF,22,MEM,17,8,380,52,133,0.391,23,65,0.354,29,68,0.426,0.477,21,24,0.875,12,65,77,23,9,5,23,34,148,478
Zion Williamson,PF,23,NOP,16,16,504,146,260,0.562,2,4,0.5,144,256,0.563,0.565,78,119,0.655,32,61,93,80,17,5,40,40,372,479
Dylan Windler,SF,27,NYK,3,0,7,1,2,0.5,1,2,0.5,0,0,,0.75,0,0,,0,1,1,1,0,0,0,1,3,481
James Wiseman,C,22,DET,10,0,111,24,37,0.649,0,1,0.0,24,36,0.667,0.649,6,11,0.545,10,22,32,3,1,3,8,18,54,482
Christian Wood,PF,28,LAL,20,1,414,51,114,0.447,14,52,0.269,37,62,0.597,0.509,30,43,0.698,18,103,121,16,4,12,26,37,146,483
Delon Wright,PG,31,WAS,8,0,141,11,30,0.367,4,11,0.364,7,19,0.368,0.433,14,16,0.875,3,17,20,35,13,1,4,6,40,484
Thaddeus Young,PF,35,TOR,3,0,10,2,4,0.5,0,0,,2,4,0.5,0.5,0,2,0.0,1,2,3,3,0,0,1,0,4,485
Trae Young,PG,25,ATL,17,17,612,133,329,0.404,50,143,0.35,83,186,0.446,0.48,139,160,0.869,10,40,50,180,27,0,64,27,455,486
Omer Yurtseven,C,25,UTA,13,4,143,24,43,0.558,3,12,0.25,21,31,0.677,0.593,5,7,0.714,17,34,51,8,2,6,9,17,56,487
Cody Zeller,C,31,NOP,16,0,155,9,28,0.321,0,1,0.0,9,27,0.333,0.321,9,20,0.45,18,33,51,18,3,2,6,19,27,488
Ivica Zubac,C,26,LAC,18,18,467,88,144,0.611,0,0,,88,144,0.611,0.611,36,58,0.621,59,105,164,15,2,25,22,46,212,489
